2 13 31
###############################
#1  ** # 2  *p    f *   #  b  #
# # # #*# # #*#*# # # #*#*#*# #
#  x*     b**  *  1   * 2 * * #
# # # # # #*# # #*#*# # # # #*#
#f         x **  *  *   1     #
# # # # # # # # # #*# #*# # # #
#*  *      *  f      *        #
# # # # #*# # # #*#*# # # # # #
#*    **  *       *           #
# #*# # # # # # #*# # # # # # #
#           s   *  *          #
###############################